[TileSet]
tilesheet/tileset.png

[Map]
27 27 27 27 27 27 27 27 27 27 27 27 27 27 27 27 27 27 27 27 27 27 27
27 27 27 27 27 27 27 27 27 27 27 27 27 27 27 27 27 27 27 27 27 27 27
27 27 26 26 26 26 26 26 26 26 26 26 26 26 26 26 26 26 26 26 26 27 27 
27 27 26 26 26 26 26 26 26 26 26 26 26 26 26 26 26 26 26 26 26 27 27 
27 27 26 26 25 25 25 25 25 25 25 25 25 25 25 25 25 25 25 26 26 27 27 
27 27 26 26 25 25 25 25 25 25 25 25 25 25 25 25 25 25 25 26 26 27 27 
27 27 26 26 25 25 25 25 25 25 25 25 25 25 25 25 25 25 25 26 26 27 27 
27 27 26 26 25 25 25 25 25 25 25 25 25 25 25 25 25 25 25 26 26 27 27 
27 27 26 26 25 25 25 25 25 25 25 25 25 25 25 25 25 25 25 26 26 27 27 
27 27 26 26 25 25 25 25 25 25 25 25 25 25 25 25 25 25 25 26 26 27 27 
27 27 26 26 25 25 25 25 25 25 25 25 25 25 25 25 25 25 25 26 26 27 27 
27 27 26 26 25 25 25 25 25 25 25 25 25 25 25 25 25 25 25 26 26 27 27 
27 27 26 26 25 25 25 25 25 25 25 25 25 25 25 25 25 25 25 26 26 27 27 
27 27 26 26 25 25 25 25 25 25 25 25 25 25 25 25 25 25 25 26 26 27 27
27 27 26 26 25 25 25 25 25 25 25 25 25 25 25 25 25 25 25 26 26 27 27 
27 27 26 26 26 26 26 26 26 26 26 26 26 26 26 26 26 26 26 26 26 27 27 
27 27 26 26 26 26 26 26 26 26 26 26 26 26 26 26 26 26 26 26 26 27 27
27 27 27 27 27 27 27 27 27 27 27 27 27 27 27 27 27 27 27 27 27 27 27
27 27 27 27 27 27 27 27 27 27 27 27 27 27 27 27 27 27 27 27 27 27 27