[TileSet]
tilesheet/tileset.png

[Map] 
12 12 12 12 12 12 12 12 12 12 12 12 12 12 12 12 12 12 12 12 12 12 12
13 3 3 3 3 3 3 3 3 3 3 3 3 3 3 3 3 3 3 3 3 3 14
13 3 3 3 8 9 10 3 3 3 8 9 10 3 3 3 8 9 10 3 3 3 14
13 3 3 3 3 3 3 3 3 3 3 3 3 3 3 3 3 3 3 3 3 3 14
13 3 3 3 8 9 10 3 3 3 8 9 10 3 3 3 8 9 10 3 3 3 14
13 3 3 3 3 3 3 3 3 3 3 3 3 3 3 3 3 3 3 3 3 3 14
13 3 3 3 8 9 10 3 3 3 8 9 10 3 3 3 8 9 10 3 3 3 14
13 3 3 3 3 3 3 3 3 3 3 3 3 3 3 3 3 3 3 3 3 3 14
27 2 2 2 2 2 2 2 2 2 2 2 2 2 2 2 2 2 2 2 2 2 14
27 2 2 2 2 2 2 2 2 2 2 2 2 2 2 2 2 2 2 2 2 2 14
27 2 2 2 2 2 2 2 2 2 2 2 2 2 2 2 2 2 2 2 2 2 14
13 3 3 3 3 3 3 3 3 3 3 3 3 3 3 3 3 3 3 3 3 3 14
13 3 3 3 8 9 10 3 3 3 8 9 10 3 3 3 8 9 10 3 3 3 14
13 3 3 3 3 3 3 3 3 3 3 3 3 3 3 3 3 3 3 3 3 3 14
13 3 3 3 8 9 10 3 3 3 8 9 10 3 3 3 8 9 10 3 3 3 14
13 3 3 3 3 3 3 3 3 3 3 3 3 3 3 3 3 3 3 3 3 3 14
13 3 3 3 8 9 10 3 3 3 8 9 10 3 3 3 8 9 10 3 3 3 14
13 3 3 3 3 3 3 3 3 3 3 3 3 3 3 3 3 3 3 3 3 3 14
11 11 11 11 11 11 11 11 11 11 11 11 11 11 11 11 11 11 11 11 11 11 11


4 7 7 7 6
4 8 9 10 6
4 5 5 5 6
