[TileSet]
tilesheet/tileset.png

[Map]
12 12 12 12 12 12 12 12 12 12 12 12 12 12 12 12 12 12 12 12 12 12 12
13 17 2 2 2 2 2 2 2 2 2 2 2 2 2 2 2 2 2 2 2 18 14
13 2 2 2 2 2 2 2 2 2 2 2 2 2 2 2 2 2 2 2 2 2 14
13 2 2 3 3 3 3 2 2 2 2 2 2 2 2 3 3 3 3 2 2 2 14
13 2 2 3 3 3 3 2 2 2 2 2 2 2 2 3 3 3 3 2 2 2 14
13 2 2 3 3 3 3 2 2 2 2 2 2 2 2 3 3 3 3 2 2 2 14
13 2 2 3 3 3 3 2 2 2 2 2 2 2 2 3 3 3 3 2 2 2 14
13 2 2 2 2 2 2 2 2 2 2 2 2 2 2 2 2 2 2 2 2 2 14
24 2 4 7 7 7 6 2 2 2 2 2 2 2 2 4 7 7 7 6 2 2 2
24 2 4 8 9 10 6 2 2 2 2 2 2 2 2 4 8 9 10 6 2 2 2
24 2 4 5 5 5 6 2 2 2 2 2 2 2 2 4 5 5 5 6 2 2 2
13 2 2 2 2 2 2 2 2 2 2 2 2 2 2 2 2 2 2 2 2 2 14
13 2 2 3 3 3 3 2 2 2 2 2 2 2 2 3 3 3 3 2 2 2 14
13 2 2 3 3 3 3 2 2 2 2 2 2 2 2 3 3 3 3 2 2 2 14
13 2 2 3 3 3 3 2 2 2 2 2 2 2 2 3 3 3 3 2 2 2 14
13 2 2 3 3 3 3 2 2 2 2 2 2 2 2 3 3 3 3 2 2 2 14
13 2 2 2 2 2 2 2 2 2 2 2 2 2 2 2 2 2 2 2 2 2 14
13 16 2 2 2 2 2 2 2 2 2 2 2 2 2 2 2 2 2 2 2 15 14
11 11 11 11 11 11 11 11 11 11 11 11 11 11 11 11 11 11 11 11 11 11 11