[TileSet]
tilesheet/tileset.png

[Map] 
12 12 12 12 12 12 12 12 12 12 12 12 12 12 12 12 12 12 12 12 12 12 12
13 3 3 3 3 3 3 3 3 3 2 2 2 3 3 3 3 3 3 3 3 3 14
13 3 3 3 3 3 3 3 3 3 2 2 2 3 3 3 3 3 3 3 3 3 14
13 3 8 9 10 3 8 9 10 3 2 2 2 3 8 9 10 3 8 9 10 3 14
13 3 3 3 3 3 3 3 3 3 2 2 2 3 3 3 3 3 3 3 3 3 14
13 3 3 3 3 3 3 3 3 3 2 2 2 3 3 3 3 3 3 3 3 3 14
13 3 8 9 10 3 8 9 10 3 2 2 2 3 8 9 10 3 8 9 10 3 14
13 3 3 3 3 3 3 3 3 3 2 2 2 3 3 3 3 3 3 3 3 3 14
13 3 3 3 3 3 3 3 3 3 2 2 2 3 3 3 3 3 3 3 3 3 14
13 3 8 9 10 3 8 9 10 3 2 2 2 3 8 9 10 3 8 9 10 3 14
13 3 3 3 3 3 3 3 3 3 2 2 2 3 3 3 3 3 3 3 3 3 14
13 3 3 3 3 3 3 3 3 3 2 2 2 3 3 3 3 3 3 3 3 3 14
13 3 8 9 10 3 8 9 10 3 2 2 2 3 8 9 10 3 8 9 10 3 14
13 3 3 3 3 3 3 3 3 3 2 2 2 3 3 3 3 3 3 3 3 3 14
13 3 3 3 3 3 3 3 3 3 2 2 2 3 3 3 3 3 3 3 3 3 14
13 3 8 9 10 3 8 9 10 3 2 2 2 3 8 9 10 3 8 9 10 3 14
13 3 3 3 3 3 3 3 3 3 2 2 2 3 3 3 3 3 3 3 3 3 14
13 3 3 3 3 3 3 3 3 3 2 2 2 3 3 3 3 3 3 3 3 3 14
11 11 11 11 11 11 11 11 11 11 0 0 0 11 11 11 11 11 11 11 11 11 11