[TileSet]
tilesheet/tileset.png

[Map]
24 24 24 24 24 24 24 24 24 24 24 24 24 24 24 24 24 24 24 24 24 24 24
24 23 23 23 23 23 23 23 23 23 23 23 23 23 23 23 23 23 23 23 23 23 24
24 23 22 22 22 22 22 22 22 22 22 22 22 22 22 22 22 22 22 22 22 23 24
24 23 22 22 22 22 22 22 22 22 22 22 22 22 22 22 22 22 22 22 22 23 24
24 23 22 22 22 22 22 22 22 22 22 22 22 22 22 22 22 22 22 22 22 23 24
24 23 22 22 22 22 22 22 22 22 22 22 22 22 22 22 22 22 22 22 22 23 24
24 23 22 22 22 22 22 22 22 22 22 22 22 22 22 22 22 22 22 22 22 23 24
24 23 22 22 22 22 22 22 22 22 22 22 22 22 22 22 22 22 22 22 22 23 24
24 23 22 22 22 22 22 22 22 22 22 22 22 22 22 22 22 22 22 22 22 23 24
24 23 22 22 22 22 22 22 22 22 22 22 22 22 22 22 22 22 22 22 22 23 24
24 23 22 22 22 22 22 22 22 22 22 22 22 22 22 22 22 22 22 22 22 23 24
24 23 22 22 22 22 22 22 22 22 22 22 22 22 22 22 22 22 22 22 22 23 24
24 23 22 22 22 22 22 22 22 22 22 22 22 22 22 22 22 22 22 22 22 23 24
24 23 22 22 22 22 22 22 22 22 22 22 22 22 22 22 22 22 22 22 22 23 24
24 23 22 22 22 22 22 22 22 22 22 22 22 22 22 22 22 22 22 22 22 23 24
24 23 22 22 22 22 22 22 22 22 22 22 22 22 22 22 22 22 22 22 22 23 24
24 23 22 22 22 22 22 22 22 22 22 22 22 22 22 22 22 22 22 22 22 23 24
24 23 23 23 23 23 23 23 23 23 23 23 23 23 23 23 23 23 23 23 23 23 24
24 24 24 24 24 24 24 24 24 24 24 24 24 24 24 24 24 24 24 24 24 24 24